NO textures/greybrickwall007x800.xpm
WE textures/shingle.xpm
SO textures/StoneFloorTexture.xpm
EA textures/wood2.xpm


F 220,100,255
C 20,20,20




11111111
110000011
11000001N1
1100000001
111111011111
     10001111
     1111111