NO textures/StoneFloorTexture.xpm
SO textures/StoneFloorTexture.xpm
WE textures/StoneFloorTexture.xpm
EA textures/StoneFloorTexture.xpm


F 220,100,255
C 20,20,20



11111
100011
10001S1
1000001
1111101
000001