NO textures/greybrickwall007x800.xpm
SO textures/shingle.xpm
WE textures/StoneFloorTexture.xpm
EA textures/wood2.xpm


F 220,100,255
C 20,20,20


1111111111111111111111111
1000000000000010000000001
1011111111111010111111101
1010000000000010000000101
1010111111111111111100101
1010100000010000000100101
1010101111010111110100101
1010101000010100010100101
1010101011110111010100101
1010101010000001010100101
1010101010111111010100101
1010101000100000010100101
1010111111101111111100101
1010000000001000000000001
1011111111111011111111101
1010000000010000000000101
1010111111011111111100101
1010100001000000000100101
1010101111111111110100101
1010001000000000010000E01
1111111111111111111111111


